XCCCCCCCCCCCCCCCCCCX
XC................CX
XC..CC.C.CC.C.CC..CX
XC.CC..........CC.CX
XC......C..C......CX
XC.CCC...CC...CCC.CX
CC..C..........C..CC
.......CCXXCC.......
CC.C.C.CXXXXC.C.C.CC
XC.CCC.CCCCCC.CCC.CX
XC................CX
XC.CCCC..CC..CCCC.CX
XC....C.CCCC.C....CX
XCCCC..........CCCCX
XCCCCCCCCCCCCCCCCCCX