X111111111111111111X
X100000000000000001X
X100110101101011001X
X101100000000001101X
X100000010010000001X
X101110001100011101X
11001000000000010011
000000011XX110000000
11010101XXXX10101011
X101110111111011101X
X100000000000000001X
X101111001100111101X
X100001011110100001X
X111100000000001111X
X111111111111111111X